00000000000
00111101100
00000001100
00111100000
00000000010
01001100010
01001100010
01000000010
01010000000
00010111100
00000000000