1111111111111
1000000000001
1001111011001
1000000011001
1001111000001
1000000000101
1010011000101
1010011000101
1010000000101
1010100000001
1000101111001
1000000000001
1111111111111